8 8 8 8 8 8 8 8 8 8
8 9 4 1 1 3 9 9 9 8
8 8 2 8 8 7 4 1 3 9
8 8 2 9 8 6 5 8 2 8
8 9 6 1 1 3 8 8 2 9
8 8 8 8 8 6 1 1 5 8
